IBAN/BBAN,"Munt","BIC","Volgnr","Datum","Rentedatum","Bedrag","Saldo na trn","Tegenrekening IBAN/BBAN","Naam tegenpartij","Naam uiteindelijke partij","Naam initiÃ«rende partij","BIC tegenpartij","Code","Batch ID","Transactiereferentie","Machtigingskenmerk","Incassant ID","Betalingskenmerk","Omschrijving-1","Omschrijving-2","Omschrijving-3","Reden retour","Oorspr bedrag","Oorspr munt","Koers"
NL21RABO0385559933,"EUR","RABONL2U","000000000000000220","2025-05-29","2025-05-29","+31,80","+198,86","NL42RABO0114668043","Rabo Betaalverzoek","","J.H.N. Visser","RABONL2U","bv","OO9B004613332179","0022325747426041","","","","NL10ASNB0708883869:J.H.N. Visser:Bierlijst 29/5"," ","","","","",""
NL21RABO0385559933,"EUR","RABONL2U","000000000000000221","2025-06-01","2025-06-01","+10,00","+208,86","NL78RABO0338328637","M.E. Griffioen","","","RABONL2UXXX","cb","OO9B004507077792","","","","","Huisrekening geld"," ","","","","",""
NL21RABO0385559933,"EUR","RABONL2U","000000000000000222","2025-06-03","2025-06-01","-3,45","+205,41","NL21RABO0385559933","Rabobank","","","","db","","","","","","Kosten                             Rabo DirectPakket                  Periode 01-06-2025 t/m 30-06-2025"," ","","","","",""
NL21RABO0385559933,"EUR","RABONL2U","000000000000000223","2025-06-05","2025-06-06","-2,50","+202,91","NL58ASNB0707064546","E.A. van Kats via ASN Bank Betaalverzoek","","","ASNBNL21XXX","id","OO9B004639447207","05-06-2025 20:58 7750446364954267","","","","EAvanKats 7750446364954267 Afwasborstels NL87ASNB0708070981 xui-25674248"," ","","","","",""
NL21RABO0385559933,"EUR","RABONL2U","000000000000000224","2025-06-07","2025-06-07","+10,00","+212,91","NL79RABO0311522378","Nathalie van Wijk","","","RABONL2UXXX","tb","OO9B004527529380","","","","","Huisrekening"," ","","","","",""
NL21RABO0385559933,"EUR","RABONL2U","000000000000000225","2025-06-07","2025-06-07","+10,00","+222,91","NL86RABO0300660871","D.A.W. Cobelens","","","RABONL2UXXX","cb","OO9B004527545278","","","",""," "," ","","","","",""
NL21RABO0385559933,"EUR","RABONL2U","000000000000000226","2025-06-07","2025-06-07","+10,00","+232,91","NL55RABO0302689990","M. Baalbergen","","","RABONL2UXXX","cb","OO9B004527534865","","","","","Huisrekening Marthe"," ","","","","",""
NL21RABO0385559933,"EUR","RABONL2U","000000000000000227","2025-06-08","2025-06-09","-23,80","+209,11","NL13ABNA0506417344","Visser via Tikkie","","","ABNANL2AXXX","id","OO9B004647712001","08-06-2025 13:17 0031616662035912","","","","001037012816 0031616662035912 Bierkratten NL10ASNB0708883869 xui-25674248"," ","","","","",""
